When using: give credit to CSS Open-source Libary

Usage:
buttons:
button-white-round = round White button
button-black-round = round black button
button-red-round = round red button
button-blue-round = round blue button
button-orange-round = round orange button
button-yellow-round = round Yellow button
button-purple-round = round purple button
button-turquoise-round = round turquoise button
button-green-round = round green button

button-white-square = square White button
button-black-square = square black button
button-red-square = square red button
button-blue-square = square blue button
button-orange-square = square orange button
button-yellow-square = square Yellow button
button-purple-square = square purple button
button-turquoise-square = square turquoise button
button-green-square = square green button

to add shadows
button-white-shadow = shadow on White button
button-black-shadow = shadow on black button
button-red-shadow = shadow on red button
button-blue-shadow = shadow on blue button
button-orange-shadow = shadow on orange button
button-yellow-shadow = shadow on Yellow button
button-purple-shadow = shadow on purple button
button-turquoise-shadow = shadow on turquoise button
button-green-shadow = shadow green on button

 








